XXXXXXXXXXXXXXXXXXXXXX
X....................X
X..###..UU...........X
X..#.#..............#X
X..........#...#.....X
X..........#####.....X
X..###..............#X
X..###..............#X
X....................X
X...........XXXXXXX..X
X....................X
X....................X
X..###...............X
X..#.#.....F.........X
X....................X
X....E...............X
X..###..............#X
X..###.....F.....E..#X
X....................X
X...E................X
XXXXXXXXXXXXXXXXXXXXXX