....................
..###...U...........
..#.#..............#
..........#...#.....
..........#####.....
..###..............#
..###.......U......#
....................
...........XXXXXXX..
.................X..
...........X.....X..
..###......XXXXXXX..
..#.#.....F.........
....................
....................
..###..............#
..###.....F.....E..#
....................
...E................
