....................
..###...U...........
..#.#..............#
..........#...#.....
..........#####.....
..###..............#
..###.......U......#
....................
....................
....................
....................
..###...............
..#.#...............
....................
....................
..###..............#
..###...........E..#
....................
...E................
