....................
..###...U...........
..#.#..............#
..........#...#.....
..........#####.....
..###..............#
..###.......U......#
....................
...........XXXXXXX..
....................
....................
..###...........E...
..#.#.....F.........
..............E.....
....E..........F....
..###..E...........#
..###.....F.....E..#
....................
...E................
